NO             textures/wall.xpm
EA     textures/wall.xpm
SO textures/wall.xpm
WE textures/wall.xpm
F 19,109,21
C 160,217,239



    1111111111111111111111111111
        1111000000000100100011111
       11011000001110100100000001
111111110010000001000000110110011
1000000100000000110001011001111
10000001000000001100010010001
10000001000000001100010010001
10000000000000001100010010001
10000001000000001100010000001
11000001110101011110011110N011
11111111 1111111 111111111111
